1234567891
1        2
1  1     2
1  1     2
1        2
1        2
1        2
1        2
1        2
1        2
1        2
1        2
1        2
1111111222