3456345634
6        5
5        6
4        3
354      4
6        5
4        6
3    5   3
5        4
6543654365