3456345634  
6        5
5    3   6
4   33   3
3    3   4
6    4   5
4    3   6
3        3
5    9   4
6543654365