3453345334  
3        5
5    3   3
4   33   3
3    3   4
3    4   5
4    3   3
3        3
5    a   4
3543354335