3456345634  
6       95
5        6
4        3
354      4
6        5
4        6
3        3
5        4
6543654365