7886788678  
6        8
8        6
8        7
7  8     8
6  8     8
8  8 a   6
7  8     7
8888     8
6887688768