3456345634  
6        5
5        6
4        3
3        4
6        5
45544    6
39  5    3
5        4
6543654365