9192919291  
2        9
9   111112
1   9    9
9        1
2        9
1   1    2
9   9    9
9   9a   1
2919291929